00000033330000003333
00001110000000111000
00000110000000111000
01100000000000111000
00011100000000111000
00000000000000111000
00022200000000111000
00000000000000111000
03333330000000111000
00000333030000111000
00000333030000111000
00000333030000111000
00000333030000111000