0000003333
0000111000
0000011000
0110000000
0001110000
0000000000
0002220000
0000000000
0333333000
0000033303